"   " "▒▒▒" "▒▒▒" "▒▒▒" "▒▒▒" "▒▒▒" "▒▒▒" "▒▒▒" "▒▒▒" "▒▒▒" "▒▒▒" "▒▒▒" "▒▒▒" "▒▒▒" "▒▒▒" "▒▒▒" "▒▒▒" "▒▒▒" "▒▒▒" "▒▒▒" "▒▒▒" "▒▒▒" "▒▒▒" "▒▒▒" "▒▒▒" "▒▒▒" "▒▒▒" "▒▒▒" "▒▒▒" "▒▒▒" "▒▒▒" "▒▒▒" "▒▒▒" "▒▒▒" "▒▒▒" "▒▒▒" "▒▒▒" "▒▒▒" "▒▒▒" "▒▒▒" "▒▒▒" "▒▒▒" "▒▒▒" "▒▒▒" "▒▒▒" "▒▒▒" "▒▒▒" "▒▒▒" "▒▒▒" "▒▒▒" 
"   " "▒▒▒" "▒▒▒" "▒▒▒" "▒▒▒" "▒▒▒" "▒▒▒" "   " "   " "   " "   " "▒▒▒" "▒▒▒" "▒▒▒" "▒▒▒" "▒▒▒" "▒▒▒" "▒▒▒" "▒▒▒" "▒▒▒" "▒▒▒" "▒▒▒" "▒▒▒" "▒▒▒" "▒▒▒" "▒▒▒" "▒▒▒" "▒▒▒" "▒▒▒" "▒▒▒" "▒▒▒" "▒▒▒" "▒▒▒" "▒▒▒" "▒▒▒" "▒▒▒" "   " "   " "   " "   " "   " "   " "   " "▒▒▒" "▒▒▒" "▒▒▒" "▒▒▒" "   " "   " "▒▒▒"
"   " "   " "   " "   " "   " " ? " "   " "▒▒▒" "▒▒▒" "▒▒▒" "   " "▒▒▒" "▒▒▒" "▒▒▒" "▒▒▒" "▒▒▒" "   " "   " "   " "   " "   " "   " "   " "   " "   " "   " "   " "   " "   " "   " "   " "   " "   " "▒▒▒" "▒▒▒" "▒▒▒" "   " "▒▒▒" "   " "▒▒▒" "▒▒▒" "▒▒▒" "   " "▒▒▒" "▒▒▒" "▒▒▒" "▒▒▒" "   " "▒▒▒" "▒▒▒"
"▒▒▒" "▒▒▒" "▒▒▒" "▒▒▒" "▒▒▒" "▒▒▒" "   " "▒▒▒" "▒▒▒" "▒▒▒" " ? " "▒▒▒" "▒▒▒" "▒▒▒" "▒▒▒" "▒▒▒" "   " "▒▒▒" "▒▒▒" "▒▒▒" "▒▒▒" "▒▒▒" "▒▒▒" "▒▒▒" "▒▒▒" "▒▒▒" "▒▒▒" "▒▒▒" "▒▒▒" "▒▒▒" "▒▒▒" "▒▒▒" "   " "▒▒▒" "▒▒▒" "▒▒▒" "   " "▒▒▒" "   " "▒▒▒" "▒▒▒" "▒▒▒" "   " "   " "   " "   " "   " "   " "▒▒▒" "▒▒▒"
"▒▒▒" "▒▒▒" "▒▒▒" "▒▒▒" "▒▒▒" "▒▒▒" "   " "▒▒▒" "▒▒▒" "▒▒▒" "   " "▒▒▒" "▒▒▒" "▒▒▒" "▒▒▒" "▒▒▒" "   " "▒▒▒" "▒▒▒" "▒▒▒" "▒▒▒" "▒▒▒" "▒▒▒" "▒▒▒" "▒▒▒" "▒▒▒" "▒▒▒" "▒▒▒" "▒▒▒" "▒▒▒" "▒▒▒" "▒▒▒" "   " "▒▒▒" "▒▒▒" "▒▒▒" "   " "▒▒▒" "   " "▒▒▒" "▒▒▒" "▒▒▒" "   " "▒▒▒" "▒▒▒" "▒▒▒" "▒▒▒" "▒▒▒" "▒▒▒" "▒▒▒"
"▒▒▒" "▒▒▒" "▒▒▒" "▒▒▒" "▒▒▒" "▒▒▒" "   " "   " "   " "   " "   " "   " "   " "   " "   " "   " "   " "▒▒▒" "▒▒▒" "▒▒▒" "▒▒▒" "▒▒▒" "▒▒▒" "▒▒▒" "▒▒▒" "▒▒▒" "▒▒▒" "▒▒▒" "▒▒▒" "▒▒▒" "▒▒▒" "▒▒▒" "   " "▒▒▒" "▒▒▒" "▒▒▒" "   " "▒▒▒" "   " "   " "   " "▒▒▒" "   " "▒▒▒" "▒▒▒" "▒▒▒" "▒▒▒" "▒▒▒" "▒▒▒" "▒▒▒"
"▒▒▒" "▒▒▒" "▒▒▒" "▒▒▒" "▒▒▒" "▒▒▒" "▒▒▒" "▒▒▒" "▒▒▒" "▒▒▒" "▒▒▒" "▒▒▒" "▒▒▒" "▒▒▒" "▒▒▒" "▒▒▒" "▒▒▒" "▒▒▒" "▒▒▒" "▒▒▒" "   " "   " "   " "   " "   " "   " "   " "▒▒▒" "▒▒▒" "▒▒▒" "▒▒▒" "▒▒▒" "   " "▒▒▒" "▒▒▒" "▒▒▒" "   " "▒▒▒" "▒▒▒" "▒▒▒" " ? " "▒▒▒" "   " "▒▒▒" "▒▒▒" "▒▒▒" "▒▒▒" "▒▒▒" "▒▒▒" "▒▒▒"
"▒▒▒" "▒▒▒" "▒▒▒" "▒▒▒" "▒▒▒" "▒▒▒" "▒▒▒" "▒▒▒" "▒▒▒" "▒▒▒" "▒▒▒" "▒▒▒" "▒▒▒" "▒▒▒" "▒▒▒" "▒▒▒" "▒▒▒" "▒▒▒" "▒▒▒" "▒▒▒" "   " "▒▒▒" "▒▒▒" "   " "▒▒▒" "▒▒▒" "   " "▒▒▒" "▒▒▒" "▒▒▒" "▒▒▒" "▒▒▒" "   " "▒▒▒" "▒▒▒" "▒▒▒" "   " "▒▒▒" "▒▒▒" "▒▒▒" "   " "▒▒▒" "   " "▒▒▒" "▒▒▒" "▒▒▒" "▒▒▒" "▒▒▒" "▒▒▒" "▒▒▒"
"▒▒▒" "▒▒▒" "▒▒▒" "▒▒▒" "▒▒▒" "▒▒▒" "▒▒▒" "▒▒▒" "▒▒▒" "▒▒▒" "▒▒▒" "▒▒▒" "▒▒▒" "▒▒▒" "▒▒▒" "▒▒▒" "▒▒▒" "▒▒▒" "▒▒▒" "▒▒▒" "   " "▒▒▒" "▒▒▒" "   " "▒▒▒" "▒▒▒" "   " "▒▒▒" "▒▒▒" "▒▒▒" "▒▒▒" "▒▒▒" "   " "   " "   " "   " "   " "▒▒▒" "▒▒▒" "▒▒▒" "   " "▒▒▒" "   " "▒▒▒" "▒▒▒" "   " "   " "   " "   " "▒▒▒"
"▒▒▒" "   " "   " "   " "   " "   " "   " "   " "   " "   " "   " "   " "   " "   " "   " "   " "▒▒▒" "▒▒▒" "▒▒▒" "▒▒▒" "   " "▒▒▒" "▒▒▒" " ? " "▒▒▒" "▒▒▒" "   " "▒▒▒" "▒▒▒" "▒▒▒" "▒▒▒" "▒▒▒" "▒▒▒" "▒▒▒" "▒▒▒" "▒▒▒" "▒▒▒" "▒▒▒" "▒▒▒" "▒▒▒" "   " "▒▒▒" "   " "▒▒▒" "▒▒▒" "   " "▒▒▒" "▒▒▒" "   " "▒▒▒"
"▒▒▒" "   " "▒▒▒" "▒▒▒" "   " "▒▒▒" "▒▒▒" "▒▒▒" "▒▒▒" "▒▒▒" "   " "▒▒▒" "▒▒▒" "▒▒▒" "▒▒▒" "   " "▒▒▒" "▒▒▒" "▒▒▒" "▒▒▒" "   " "▒▒▒" "▒▒▒" "   " "▒▒▒" "▒▒▒" "   " "▒▒▒" "▒▒▒" "   " "   " "   " "   " "   " "   " "   " "   " "   " "   " "   " "   " "▒▒▒" "   " "▒▒▒" "▒▒▒" "   " "▒▒▒" "▒▒▒" "   " "▒▒▒"
"▒▒▒" "   " "▒▒▒" "▒▒▒" "   " "▒▒▒" "▒▒▒" "▒▒▒" "▒▒▒" "▒▒▒" "   " "▒▒▒" "▒▒▒" "▒▒▒" "▒▒▒" "   " "▒▒▒" "▒▒▒" "▒▒▒" "▒▒▒" "   " "▒▒▒" "▒▒▒" "   " "▒▒▒" "▒▒▒" "   " "▒▒▒" "▒▒▒" "▒▒▒" "▒▒▒" "▒▒▒" "▒▒▒" "▒▒▒" "▒▒▒" "▒▒▒" "▒▒▒" "▒▒▒" "▒▒▒" "▒▒▒" "▒▒▒" "▒▒▒" "   " "▒▒▒" "▒▒▒" "   " "▒▒▒" "▒▒▒" "   " "▒▒▒"
"▒▒▒" "   " "▒▒▒" "▒▒▒" "   " "▒▒▒" "▒▒▒" "▒▒▒" "▒▒▒" "▒▒▒" "   " "▒▒▒" "▒▒▒" "▒▒▒" "▒▒▒" "   " "▒▒▒" "▒▒▒" "▒▒▒" "▒▒▒" "   " "▒▒▒" "   " "   " "▒▒▒" "▒▒▒" "   " "   " "   " "   " "   " "   " "   " "   " "   " "   " "   " "   " "   " "   " "▒▒▒" "▒▒▒" "   " "   " "   " "   " "▒▒▒" "▒▒▒" "   " "▒▒▒" 
"▒▒▒" "   " "▒▒▒" "▒▒▒" "   " "▒▒▒" "   " "   " "   " "   " "   " "▒▒▒" "▒▒▒" "▒▒▒" "▒▒▒" "   " "▒▒▒" "▒▒▒" "▒▒▒" "▒▒▒" "   " "▒▒▒" "   " "▒▒▒" "▒▒▒" "▒▒▒" "▒▒▒" "▒▒▒" "▒▒▒" "▒▒▒" "▒▒▒" "▒▒▒" "▒▒▒" "▒▒▒" "▒▒▒" "▒▒▒" "▒▒▒" "▒▒▒" "▒▒▒" "   " "▒▒▒" "▒▒▒" "▒▒▒" "   " "▒▒▒" "▒▒▒" "▒▒▒" "▒▒▒" " ? " "▒▒▒" 
"▒▒▒" "   " "▒▒▒" "▒▒▒" "   " "▒▒▒" "   " "▒▒▒" "▒▒▒" "▒▒▒" "▒▒▒" "▒▒▒" "▒▒▒" "▒▒▒" "▒▒▒" "   " "▒▒▒" "▒▒▒" "▒▒▒" "▒▒▒" "   " "▒▒▒" "   " "▒▒▒" "▒▒▒" "▒▒▒" "▒▒▒" "▒▒▒" "▒▒▒" "▒▒▒" "▒▒▒" "▒▒▒" "▒▒▒" "▒▒▒" "▒▒▒" "▒▒▒" "▒▒▒" "▒▒▒" "▒▒▒" "   " "▒▒▒" "▒▒▒" "▒▒▒" "   " "▒▒▒" "▒▒▒" "▒▒▒" "▒▒▒" "   " "▒▒▒" 
"▒▒▒" "   " "▒▒▒" "▒▒▒" "   " "▒▒▒" "   " "▒▒▒" "▒▒▒" "   " "   " "   " "   " "   " "   " "   " "▒▒▒" "▒▒▒" "▒▒▒" "▒▒▒" "   " "▒▒▒" "   " "▒▒▒" "▒▒▒" "▒▒▒" "▒▒▒" "   " "   " "   " "▒▒▒" "▒▒▒" "▒▒▒" "▒▒▒" "▒▒▒" "▒▒▒" "▒▒▒" "▒▒▒" "▒▒▒" "   " "▒▒▒" "   " "   " "   " "▒▒▒" "▒▒▒" "▒▒▒" "▒▒▒" "   " "▒▒▒"
"▒▒▒" "   " "▒▒▒" "▒▒▒" "   " "▒▒▒" "   " "▒▒▒" "▒▒▒" "   " "▒▒▒" "▒▒▒" "▒▒▒" "▒▒▒" "▒▒▒" "▒▒▒" "▒▒▒" "▒▒▒" "▒▒▒" "▒▒▒" "   " "▒▒▒" "   " "   " "   " "   " "   " " ? " "▒▒▒" "   " "▒▒▒" "▒▒▒" "   " "   " "   " "   " "   " "   " "   " "   " "▒▒▒" "   " "▒▒▒" "▒▒▒" "▒▒▒" "▒▒▒" "▒▒▒" "▒▒▒" "   " "▒▒▒"
"▒▒▒" "   " "▒▒▒" "▒▒▒" "   " "▒▒▒" "   " "▒▒▒" "▒▒▒" "   " "▒▒▒" "▒▒▒" "▒▒▒" "▒▒▒" "▒▒▒" "▒▒▒" "▒▒▒" "▒▒▒" "▒▒▒" "▒▒▒" "   " "▒▒▒" "▒▒▒" "▒▒▒" "▒▒▒" "▒▒▒" "▒▒▒" "▒▒▒" "▒▒▒" "   " "▒▒▒" "▒▒▒" "   " "▒▒▒" "▒▒▒" "▒▒▒" "▒▒▒" "▒▒▒" "▒▒▒" "▒▒▒" "▒▒▒" "   " "▒▒▒" "▒▒▒" "▒▒▒" "▒▒▒" "   " "▒▒▒" "   " "▒▒▒"
"▒▒▒" "   " "▒▒▒" "▒▒▒" "   " "▒▒▒" "▒▒▒" "▒▒▒" "▒▒▒" "   " "▒▒▒" "▒▒▒" "▒▒▒" "▒▒▒" "▒▒▒" "▒▒▒" "▒▒▒" "▒▒▒" "▒▒▒" "▒▒▒" "   " "▒▒▒" "▒▒▒" "▒▒▒" "▒▒▒" "▒▒▒" "▒▒▒" "▒▒▒" "▒▒▒" "   " "▒▒▒" "▒▒▒" "   " "▒▒▒" "▒▒▒" "   " "   " "   " "   " "   " "   " "   " "▒▒▒" "▒▒▒" "▒▒▒" "▒▒▒" " ? " "▒▒▒" "   " "▒▒▒"
"▒▒▒" "   " "▒▒▒" "▒▒▒" " ? " "▒▒▒" "   " "   " "   " "   " "   " "   " "   " "   " "   " "   " "   " "   " "   " "   " "   " "▒▒▒" "▒▒▒" "▒▒▒" "▒▒▒" "▒▒▒" "▒▒▒" "▒▒▒" "▒▒▒" "   " "▒▒▒" "▒▒▒" "   " "▒▒▒" "▒▒▒" "   " "▒▒▒" "▒▒▒" "▒▒▒" "▒▒▒" "▒▒▒" "▒▒▒" "▒▒▒" "▒▒▒" "▒▒▒" "▒▒▒" "   " "▒▒▒" "   " "▒▒▒"
"▒▒▒" "   " "▒▒▒" "▒▒▒" "   " "▒▒▒" "   " "▒▒▒" "▒▒▒" "▒▒▒" "▒▒▒" "▒▒▒" "▒▒▒" "▒▒▒" "▒▒▒" "▒▒▒" "▒▒▒" "▒▒▒" "▒▒▒" "▒▒▒" "▒▒▒" "▒▒▒" "▒▒▒" "▒▒▒" "▒▒▒" "▒▒▒" "▒▒▒" "   " "   " "   " "▒▒▒" "▒▒▒" "   " "▒▒▒" "▒▒▒" "   " "   " "   " "   " "   " "   " "   " "   " "   " "   " "   " "   " "▒▒▒" "   " "▒▒▒"
"▒▒▒" "▒▒▒" "▒▒▒" "▒▒▒" "   " "▒▒▒" "   " "▒▒▒" "▒▒▒" "▒▒▒" "▒▒▒" "▒▒▒" "▒▒▒" "▒▒▒" "▒▒▒" "▒▒▒" "▒▒▒" "▒▒▒" "▒▒▒" "▒▒▒" "▒▒▒" "▒▒▒" "▒▒▒" "▒▒▒" "▒▒▒" "▒▒▒" "▒▒▒" "   " "▒▒▒" "▒▒▒" "▒▒▒" "▒▒▒" "   " "▒▒▒" "▒▒▒" "▒▒▒" "▒▒▒" "▒▒▒" "▒▒▒" "▒▒▒" "▒▒▒" "▒▒▒" "▒▒▒" "▒▒▒" "▒▒▒" "▒▒▒" "▒▒▒" "▒▒▒" "   " "▒▒▒"
"▒▒▒" "▒▒▒" "▒▒▒" "▒▒▒" "   " "▒▒▒" "   " "   " "   " "   " "   " "   " "   " "   " "   " "   " "▒▒▒" "▒▒▒" "▒▒▒" "▒▒▒" "▒▒▒" "▒▒▒" "▒▒▒" "▒▒▒" "▒▒▒" "▒▒▒" "▒▒▒" "   " "▒▒▒" "▒▒▒" "▒▒▒" "▒▒▒" "   " "   " "   " "   " "   " "   " "   " "   " "   " "   " "   " "   " "   " "   " "   " "   " "   " "▒▒▒"
"▒▒▒" "▒▒▒" "▒▒▒" "▒▒▒" "   " "▒▒▒" "▒▒▒" "▒▒▒" "▒▒▒" "▒▒▒" "▒▒▒" "▒▒▒" "▒▒▒" "▒▒▒" "▒▒▒" "   " "▒▒▒" "   " "   " "   " "   " "   " "   " "   " "   " "   " "▒▒▒" "   " "▒▒▒" "▒▒▒" "▒▒▒" "▒▒▒" "▒▒▒" "▒▒▒" "▒▒▒" "▒▒▒" "▒▒▒" "▒▒▒" "▒▒▒" "▒▒▒" "▒▒▒" "▒▒▒" "▒▒▒" "▒▒▒" "▒▒▒" "▒▒▒" "▒▒▒" "▒▒▒" "▒▒▒" "▒▒▒"
"▒▒▒" "▒▒▒" "▒▒▒" "▒▒▒" "   " "▒▒▒" "▒▒▒" "▒▒▒" "▒▒▒" "▒▒▒" "▒▒▒" "▒▒▒" "▒▒▒" "▒▒▒" "▒▒▒" "   " "▒▒▒" "   " "▒▒▒" "▒▒▒" "   " "▒▒▒" "▒▒▒" "▒▒▒" "▒▒▒" "   " "▒▒▒" "   " "   " "   " "   " "   " "   " "   " " ? " "   " "   " "   " "   " "   " "   " "   " "   " "   " "   " "▒▒▒" "▒▒▒" "▒▒▒" "▒▒▒" "▒▒▒"
"▒▒▒" "▒▒▒" "▒▒▒" "▒▒▒" "   " "   " "   " "   " "   " "   " "   " "   " "   " "▒▒▒" "▒▒▒" "   " "▒▒▒" "   " "▒▒▒" "▒▒▒" "   " "▒▒▒" "▒▒▒" "▒▒▒" "▒▒▒" "   " "▒▒▒" "▒▒▒" "▒▒▒" "▒▒▒" "▒▒▒" "▒▒▒" "▒▒▒" "▒▒▒" "▒▒▒" "▒▒▒" "▒▒▒" "▒▒▒" "▒▒▒" "▒▒▒" "▒▒▒" "▒▒▒" "▒▒▒" "▒▒▒" "   " "▒▒▒" "▒▒▒" "▒▒▒" "▒▒▒" "▒▒▒"
"▒▒▒" "▒▒▒" "▒▒▒" "▒▒▒" "▒▒▒" "▒▒▒" "▒▒▒" "▒▒▒" "▒▒▒" "▒▒▒" "▒▒▒" "▒▒▒" "   " "▒▒▒" "▒▒▒" "   " "▒▒▒" "   " "▒▒▒" "▒▒▒" "   " "▒▒▒" "▒▒▒" "▒▒▒" "▒▒▒" "   " "▒▒▒" "▒▒▒" "▒▒▒" "   " "   " "   " "   " "   " "   " "   " "   " "   " "   " "   " "   " "   " "   " "▒▒▒" "   " "▒▒▒" "▒▒▒" "▒▒▒" "▒▒▒" "▒▒▒"
"▒▒▒" "   " "   " "   " "   " "   " "▒▒▒" "▒▒▒" "▒▒▒" "▒▒▒" "▒▒▒" "▒▒▒" "   " "▒▒▒" "▒▒▒" "   " "▒▒▒" "   " "▒▒▒" "▒▒▒" "   " "▒▒▒" "▒▒▒" "▒▒▒" "▒▒▒" "   " "▒▒▒" "▒▒▒" "▒▒▒" "   " "▒▒▒" "▒▒▒" "   " "▒▒▒" "▒▒▒" "▒▒▒" "▒▒▒" "▒▒▒" "   " "▒▒▒" "▒▒▒" "▒▒▒" "   " "▒▒▒" "   " "▒▒▒" "▒▒▒" "▒▒▒" "▒▒▒" "▒▒▒"
"▒▒▒" "   " "▒▒▒" "   " "▒▒▒" "   " "▒▒▒" "▒▒▒" "▒▒▒" "▒▒▒" "▒▒▒" "▒▒▒" "   " "▒▒▒" "▒▒▒" "   " "▒▒▒" "   " "▒▒▒" "▒▒▒" "   " "▒▒▒" "▒▒▒" "▒▒▒" "▒▒▒" "   " "▒▒▒" "   " "   " "   " "▒▒▒" "▒▒▒" "   " "▒▒▒" "▒▒▒" "▒▒▒" "▒▒▒" "▒▒▒" "   " "▒▒▒" "▒▒▒" "▒▒▒" "   " "▒▒▒" "   " "▒▒▒" "▒▒▒" "▒▒▒" "▒▒▒" "▒▒▒"
"▒▒▒" "   " "▒▒▒" "   " "▒▒▒" "   " "▒▒▒" "▒▒▒" "▒▒▒" "▒▒▒" "▒▒▒" "▒▒▒" "   " "▒▒▒" "▒▒▒" "   " "▒▒▒" "   " "▒▒▒" "▒▒▒" "   " "▒▒▒" "▒▒▒" "▒▒▒" "▒▒▒" "   " "▒▒▒" "▒▒▒" "▒▒▒" "▒▒▒" "▒▒▒" "▒▒▒" "   " "▒▒▒" "▒▒▒" "▒▒▒" "▒▒▒" "▒▒▒" "   " "▒▒▒" "▒▒▒" "▒▒▒" "   " "▒▒▒" "   " "▒▒▒" "▒▒▒" "▒▒▒" "▒▒▒" "▒▒▒"
"▒▒▒" "   " "▒▒▒" "   " "▒▒▒" "   " "   " "   " "   " "   " "   " "   " "   " "▒▒▒" "▒▒▒" "   " "▒▒▒" "   " "▒▒▒" "▒▒▒" "   " "▒▒▒" "▒▒▒" "▒▒▒" "▒▒▒" "   " "▒▒▒" "▒▒▒" "▒▒▒" "▒▒▒" "▒▒▒" "▒▒▒" "   " "▒▒▒" "▒▒▒" "▒▒▒" "▒▒▒" "▒▒▒" "   " "▒▒▒" "▒▒▒" "▒▒▒" "   " "▒▒▒" "   " "▒▒▒" "▒▒▒" "▒▒▒" "▒▒▒" "▒▒▒"
"▒▒▒" "   " "▒▒▒" "   " "▒▒▒" "▒▒▒" "▒▒▒" "▒▒▒" "▒▒▒" "▒▒▒" "▒▒▒" "▒▒▒" "▒▒▒" "   " "   " "   " "▒▒▒" "   " "▒▒▒" "▒▒▒" "   " "   " "   " "   " "▒▒▒" "   " "   " "   " "   " "   " "   " "   " "   " "▒▒▒" "▒▒▒" "▒▒▒" "▒▒▒" "▒▒▒" "   " "▒▒▒" "▒▒▒" "▒▒▒" "   " "▒▒▒" "   " "▒▒▒" "▒▒▒" "▒▒▒" "▒▒▒" "▒▒▒"
"▒▒▒" " ? " "▒▒▒" "   " "▒▒▒" "▒▒▒" "▒▒▒" "▒▒▒" "▒▒▒" "▒▒▒" "▒▒▒" "▒▒▒" "▒▒▒" "▒▒▒" "▒▒▒" "▒▒▒" "▒▒▒" "   " "▒▒▒" "▒▒▒" "▒▒▒" "▒▒▒" "▒▒▒" "   " "▒▒▒" "▒▒▒" "▒▒▒" "▒▒▒" "▒▒▒" "▒▒▒" "▒▒▒" "▒▒▒" "▒▒▒" "▒▒▒" "▒▒▒" "▒▒▒" "   " "   " "   " "▒▒▒" "▒▒▒" "▒▒▒" "   " "▒▒▒" "   " "   " "   " "   " "▒▒▒" "▒▒▒"
"▒▒▒" "   " "▒▒▒" "▒▒▒" "▒▒▒" "▒▒▒" "▒▒▒" "▒▒▒" "▒▒▒" "▒▒▒" "▒▒▒" "▒▒▒" "▒▒▒" "▒▒▒" "▒▒▒" "▒▒▒" "▒▒▒" "   " "▒▒▒" "▒▒▒" "▒▒▒" "▒▒▒" "▒▒▒" "   " "▒▒▒" "▒▒▒" "▒▒▒" "▒▒▒" "▒▒▒" "▒▒▒" "▒▒▒" "▒▒▒" "▒▒▒" "▒▒▒" "▒▒▒" "▒▒▒" "   " "▒▒▒" "▒▒▒" "▒▒▒" "▒▒▒" "▒▒▒" " ? " "▒▒▒" "▒▒▒" "▒▒▒" "▒▒▒" "▒▒▒" "▒▒▒" "▒▒▒"
"▒▒▒" "   " "   " "   " "   " "   " "   " "   " "   " "   " "   " "   " "   " "   " "   " "   " "   " "   " "▒▒▒" "▒▒▒" "▒▒▒" "▒▒▒" "   " "   " "▒▒▒" "▒▒▒" "   " "   " "   " "   " "   " "   " "   " "   " "   " "▒▒▒" "   " "▒▒▒" "▒▒▒" "▒▒▒" "▒▒▒" "▒▒▒" "   " "▒▒▒" "▒▒▒" "▒▒▒" "▒▒▒" "▒▒▒" "▒▒▒" "▒▒▒"
"▒▒▒" "▒▒▒" "▒▒▒" "▒▒▒" "▒▒▒" "▒▒▒" "▒▒▒" "▒▒▒" "▒▒▒" "▒▒▒" "▒▒▒" "▒▒▒" "▒▒▒" "▒▒▒" "▒▒▒" "▒▒▒" "▒▒▒" "▒▒▒" "▒▒▒" "▒▒▒" "▒▒▒" "▒▒▒" "▒▒▒" "▒▒▒" "▒▒▒" "▒▒▒" "   " "▒▒▒" "▒▒▒" "▒▒▒" "▒▒▒" "▒▒▒" "▒▒▒" "▒▒▒" "   " "▒▒▒" "   " "▒▒▒" "▒▒▒" "▒▒▒" "▒▒▒" "▒▒▒" "   " "▒▒▒" "▒▒▒" "▒▒▒" "▒▒▒" "▒▒▒" "▒▒▒" "▒▒▒"
"▒▒▒" "▒▒▒" "   " "   " "   " "   " "   " "   " "   " "   " "   " "   " "▒▒▒" "▒▒▒" "▒▒▒" "▒▒▒" "▒▒▒" "▒▒▒" "▒▒▒" "▒▒▒" "▒▒▒" "▒▒▒" "▒▒▒" "▒▒▒" "▒▒▒" "▒▒▒" "   " "▒▒▒" "   " "   " "▒▒▒" "   " "   " "   " "   " "▒▒▒" "   " "   " "   " "   " "▒▒▒" "▒▒▒" "   " "▒▒▒" "▒▒▒" "▒▒▒" "▒▒▒" "▒▒▒" "▒▒▒" "▒▒▒"
"▒▒▒" "▒▒▒" "   " "▒▒▒" "▒▒▒" "▒▒▒" "▒▒▒" "▒▒▒" "▒▒▒" "▒▒▒" "▒▒▒" "   " "▒▒▒" "▒▒▒" "▒▒▒" "▒▒▒" "   " "   " "   " " ? " "   " "   " "▒▒▒" "▒▒▒" "▒▒▒" "▒▒▒" "   " "▒▒▒" "   " "▒▒▒" "▒▒▒" "   " "▒▒▒" "▒▒▒" "▒▒▒" "▒▒▒" "▒▒▒" "▒▒▒" "▒▒▒" "   " "▒▒▒" "▒▒▒" "   " "▒▒▒" "▒▒▒" "▒▒▒" "▒▒▒" "▒▒▒" "▒▒▒" "▒▒▒"
"▒▒▒" "▒▒▒" "   " "▒▒▒" "   " "   " "   " "   " "   " "   " "   " "   " "   " "   " "   " "▒▒▒" "   " "▒▒▒" "▒▒▒" "▒▒▒" "▒▒▒" "   " "▒▒▒" "▒▒▒" "▒▒▒" "▒▒▒" "   " "▒▒▒" "   " "▒▒▒" "▒▒▒" "   " "▒▒▒" "▒▒▒" "▒▒▒" "▒▒▒" "▒▒▒" "▒▒▒" "▒▒▒" "   " "▒▒▒" "▒▒▒" "   " "   " "   " "   " "   " "   " "▒▒▒" "▒▒▒"
"▒▒▒" "▒▒▒" "   " "▒▒▒" "   " "▒▒▒" "▒▒▒" "▒▒▒" "▒▒▒" "▒▒▒" "▒▒▒" "▒▒▒" "▒▒▒" "▒▒▒" "▒▒▒" "▒▒▒" "   " "▒▒▒" "▒▒▒" "▒▒▒" "▒▒▒" "   " "▒▒▒" "▒▒▒" "▒▒▒" "▒▒▒" "   " "▒▒▒" "   " "▒▒▒" "▒▒▒" "   " "▒▒▒" "▒▒▒" "▒▒▒" "▒▒▒" "▒▒▒" "▒▒▒" "▒▒▒" "▒▒▒" "▒▒▒" "▒▒▒" "▒▒▒" "▒▒▒" "▒▒▒" "   " "▒▒▒" "   " "▒▒▒" "▒▒▒"
"▒▒▒" "▒▒▒" "   " "▒▒▒" "   " "▒▒▒" "   " "   " "   " "   " "   " "   " "   " "▒▒▒" "▒▒▒" "▒▒▒" "   " "▒▒▒" "▒▒▒" "▒▒▒" "▒▒▒" "   " "▒▒▒" "▒▒▒" "▒▒▒" "▒▒▒" "   " "▒▒▒" "   " "▒▒▒" "▒▒▒" "   " "   " "   " "   " "   " "   " "   " "   " "   " "   " "   " "   " "   " "   " "   " "▒▒▒" "   " "▒▒▒" "▒▒▒"
"▒▒▒" "▒▒▒" "   " "▒▒▒" " ? " "▒▒▒" "   " "▒▒▒" "▒▒▒" "▒▒▒" "▒▒▒" "▒▒▒" "   " "▒▒▒" "▒▒▒" "▒▒▒" "   " "▒▒▒" "▒▒▒" "▒▒▒" "▒▒▒" "   " "▒▒▒" "▒▒▒" "▒▒▒" "▒▒▒" "   " "▒▒▒" "   " "▒▒▒" "▒▒▒" "▒▒▒" "▒▒▒" "▒▒▒" "▒▒▒" "▒▒▒" "▒▒▒" " ? " "▒▒▒" "▒▒▒" "▒▒▒" "▒▒▒" "▒▒▒" "▒▒▒" "▒▒▒" "▒▒▒" "▒▒▒" "   " "▒▒▒" "▒▒▒"
"▒▒▒" "▒▒▒" "   " "▒▒▒" "   " "▒▒▒" "   " "▒▒▒" "▒▒▒" "▒▒▒" "▒▒▒" "▒▒▒" "   " "▒▒▒" "▒▒▒" "▒▒▒" "   " "▒▒▒" "▒▒▒" "▒▒▒" "▒▒▒" "   " "▒▒▒" "▒▒▒" "▒▒▒" "▒▒▒" "   " "▒▒▒" "   " "   " "   " "   " "   " "▒▒▒" "▒▒▒" "▒▒▒" "▒▒▒" "   " "▒▒▒" "▒▒▒" "▒▒▒" "▒▒▒" "▒▒▒" "▒▒▒" "▒▒▒" "▒▒▒" "▒▒▒" "   " "▒▒▒" "▒▒▒"
"▒▒▒" "▒▒▒" " ? " "▒▒▒" "   " "▒▒▒" "   " "▒▒▒" "▒▒▒" "▒▒▒" "▒▒▒" "▒▒▒" "   " "   " "   " "   " "   " "▒▒▒" "▒▒▒" "▒▒▒" "▒▒▒" "   " "   " "   " "   " "   " "   " "▒▒▒" "   " "▒▒▒" "▒▒▒" "▒▒▒" "   " "▒▒▒" "▒▒▒" "▒▒▒" "▒▒▒" "   " "▒▒▒" "▒▒▒" "▒▒▒" "▒▒▒" "▒▒▒" "▒▒▒" "▒▒▒" "▒▒▒" "▒▒▒" "   " "▒▒▒" "▒▒▒"
"▒▒▒" "▒▒▒" "   " "▒▒▒" "   " "▒▒▒" "   " "▒▒▒" "▒▒▒" "▒▒▒" "▒▒▒" "▒▒▒" "   " "▒▒▒" "▒▒▒" "▒▒▒" "▒▒▒" "▒▒▒" "▒▒▒" "▒▒▒" "▒▒▒" "▒▒▒" "▒▒▒" "▒▒▒" "▒▒▒" "▒▒▒" "▒▒▒" "▒▒▒" "   " "▒▒▒" "▒▒▒" "▒▒▒" "   " "▒▒▒" "▒▒▒" "▒▒▒" "▒▒▒" "   " "▒▒▒" "▒▒▒" "▒▒▒" "▒▒▒" "▒▒▒" "▒▒▒" "▒▒▒" "▒▒▒" "▒▒▒" "   " "▒▒▒" "▒▒▒"
"▒▒▒" "▒▒▒" "   " "▒▒▒" "   " "   " "   " "▒▒▒" "▒▒▒" "▒▒▒" "▒▒▒" "▒▒▒" "   " "   " "   " "   " "   " "   " "   " "   " "   " "▒▒▒" "▒▒▒" "▒▒▒" "▒▒▒" "▒▒▒" "▒▒▒" "▒▒▒" "   " "▒▒▒" "▒▒▒" "▒▒▒" " ? " "▒▒▒" "▒▒▒" "▒▒▒" "▒▒▒" "   " "   " "   " "   " "   " "   " "▒▒▒" "▒▒▒" "▒▒▒" "▒▒▒" "   " "▒▒▒" "▒▒▒"
"▒▒▒" "▒▒▒" "   " "▒▒▒" "▒▒▒" "▒▒▒" "▒▒▒" "▒▒▒" "▒▒▒" "▒▒▒" "▒▒▒" "▒▒▒" "▒▒▒" "▒▒▒" "▒▒▒" "▒▒▒" "▒▒▒" "▒▒▒" "▒▒▒" "▒▒▒" "▒▒▒" "▒▒▒" "▒▒▒" "▒▒▒" "▒▒▒" "▒▒▒" "▒▒▒" "▒▒▒" "   " "▒▒▒" "▒▒▒" "▒▒▒" "   " "▒▒▒" "▒▒▒" "▒▒▒" "▒▒▒" "▒▒▒" "▒▒▒" "▒▒▒" "▒▒▒" "▒▒▒" "   " "▒▒▒" "▒▒▒" "▒▒▒" "▒▒▒" "▒▒▒" "▒▒▒" "▒▒▒"
"▒▒▒" "▒▒▒" "   " "   " "   " "   " "   " "   " "   " "   " "   " "   " "   " "   " "   " "   " "   " "   " "   " "   " "   " "   " "   " "   " "   " "   " "   " "   " "   " "▒▒▒" "▒▒▒" "▒▒▒" "   " "▒▒▒" "▒▒▒" "▒▒▒" "▒▒▒" "▒▒▒" "▒▒▒" "▒▒▒" "▒▒▒" "▒▒▒" "▒▒▒" "▒▒▒" "▒▒▒" "▒▒▒" "▒▒▒" "▒▒▒" "▒▒▒" "▒▒▒"
"▒▒▒" "▒▒▒" "▒▒▒" "▒▒▒" "▒▒▒" "▒▒▒" "▒▒▒" "▒▒▒" "▒▒▒" "▒▒▒" "▒▒▒" "▒▒▒" "▒▒▒" "▒▒▒" "▒▒▒" "▒▒▒" "▒▒▒" "▒▒▒" "▒▒▒" "▒▒▒" "▒▒▒" "▒▒▒" "▒▒▒" "▒▒▒" "▒▒▒" "▒▒▒" "▒▒▒" "▒▒▒" "▒▒▒" "▒▒▒" "▒▒▒" "▒▒▒" "   " "   " "   " "   " "   " "   " "   " "   " "   " "   " "   " "   " "   " "   " "   " "   " "   " "   "
"▒▒▒" "▒▒▒" "▒▒▒" "▒▒▒" "▒▒▒" "▒▒▒" "▒▒▒" "▒▒▒" "▒▒▒" "▒▒▒" "▒▒▒" "▒▒▒" "▒▒▒" "▒▒▒" "▒▒▒" "▒▒▒" "▒▒▒" "▒▒▒" "▒▒▒" "▒▒▒" "▒▒▒" "▒▒▒" "▒▒▒" "▒▒▒" "▒▒▒" "▒▒▒" "▒▒▒" "▒▒▒" "▒▒▒" "▒▒▒" "▒▒▒" "▒▒▒" "▒▒▒" "▒▒▒" "▒▒▒" "▒▒▒" "▒▒▒" "▒▒▒" "▒▒▒" "▒▒▒" "▒▒▒" "▒▒▒" "▒▒▒" "▒▒▒" "▒▒▒" "▒▒▒" "▒▒▒" "▒▒▒" "▒▒▒" "   "
