"   " "   " "   " "▒▒▒" "   " "   " "   " "   " "   " "   " "   " "   " "   " "   " "   " "   " "   " "▒▒▒" "   " "   " "   "
"   " "▒▒▒" "   " "▒▒▒" "   " "▒▒▒" "▒▒▒" "▒▒▒" "▒▒▒" "▒▒▒" "   " "▒▒▒" "▒▒▒" "▒▒▒" "▒▒▒" "▒▒▒" "   " "▒▒▒" "   " "▒▒▒" "   "
"   " "   " "   " "   " "   " "   " "   " "▒▒▒" "   " "   " "   " "   " "   " "▒▒▒" "   " "   " "   " "   " "   " "   " "   "
"▒▒▒" "▒▒▒" "   " "▒▒▒" "   " "▒▒▒" "   " "▒▒▒" "   " "▒▒▒" "▒▒▒" "▒▒▒" "   " "▒▒▒" "   " "▒▒▒" "   " "▒▒▒" "   " "▒▒▒" "▒▒▒"
"   " "   " "   " "▒▒▒" "   " "▒▒▒" "   " "▒▒▒" "   " "▒▒▒" "   " "▒▒▒" "   " "▒▒▒" "   " "▒▒▒" "   " "▒▒▒" "   " "   " "   " 
"   " "   " "   " "▒▒▒" "   " "▒▒▒" "   " "▒▒▒" "   " "▒▒▒" "▒▒▒" "▒▒▒" "   " "▒▒▒" "   " "▒▒▒" "   " "▒▒▒" "   " "▒▒▒" "   " 
"   " "   " "   " "▒▒▒" "   " "▒▒▒" "   " "   " "   " "   " "   " "   " "   " "   " "   " "▒▒▒" "   " "▒▒▒" "   " "   " "   " 
"▒▒▒" "▒▒▒" "▒▒▒" "▒▒▒" "   " "▒▒▒" "   " "▒▒▒" "▒▒▒" "▒▒▒" "▒▒▒" "▒▒▒" "▒▒▒" "▒▒▒" "   " "▒▒▒" "   " "▒▒▒" "▒▒▒" "▒▒▒" "▒▒▒" 
"   " "   " "   " "   " "   " "▒▒▒" "   " "   " "   " "   " "   " "   " "   " "   " "   " "▒▒▒" "   " "   " "   " "   " "   " 
"   " "▒▒▒" "▒▒▒" "▒▒▒" "▒▒▒" "▒▒▒" "   " "▒▒▒" "▒▒▒" "▒▒▒" "   " "▒▒▒" "▒▒▒" "▒▒▒" "   " "▒▒▒" "▒▒▒" "▒▒▒" "▒▒▒" "▒▒▒" "   "
"   " "   " "   " "   " "   " "   " "   " "▒▒▒" "   " "   " "   " "   " "   " "▒▒▒" "   " "   " "   " "   " "   " "   " "   " 
"   " "▒▒▒" "▒▒▒" "▒▒▒" "▒▒▒" "▒▒▒" "   " "▒▒▒" "▒▒▒" "▒▒▒" "▒▒▒" "▒▒▒" "▒▒▒" "▒▒▒" "   " "▒▒▒" "▒▒▒" "▒▒▒" "▒▒▒" "▒▒▒" "   "
"   " "   " "   " "   " "   " "▒▒▒" "   " "   " "   " "   " "   " "   " "   " "   " "   " "▒▒▒" "   " "   " "   " "   " "   " 
"▒▒▒" "▒▒▒" "▒▒▒" "▒▒▒" "   " "▒▒▒" "   " "▒▒▒" "▒▒▒" "▒▒▒" "▒▒▒" "▒▒▒" "▒▒▒" "▒▒▒" "   " "▒▒▒" "   " "▒▒▒" "▒▒▒" "▒▒▒" "▒▒▒" 
"   " "   " "   " "▒▒▒" "   " "▒▒▒" "   " "   " "   " "   " "   " "   " "   " "   " "   " "▒▒▒" "   " "▒▒▒" "   " "   " "   " 
"   " "▒▒▒" "   " "▒▒▒" "   " "▒▒▒" "   " "▒▒▒" "   " "▒▒▒" "▒▒▒" "▒▒▒" "   " "▒▒▒" "   " "▒▒▒" "   " "▒▒▒" "   " "   " "   " 
"   " "   " "   " "▒▒▒" "   " "▒▒▒" "   " "▒▒▒" "   " "▒▒▒" "   " "▒▒▒" "   " "▒▒▒" "   " "▒▒▒" "   " "   " "   " "   " "   " 
"▒▒▒" "▒▒▒" "   " "▒▒▒" "   " "▒▒▒" "   " "▒▒▒" "   " "▒▒▒" "▒▒▒" "▒▒▒" "   " "▒▒▒" "   " "▒▒▒" "   " "   " "   " "▒▒▒" "▒▒▒"
"   " "   " "   " "   " "   " "   " "   " "▒▒▒" "   " "   " "   " "   " "   " "▒▒▒" "   " "   " "   " "   " "   " "   " "   " 
"   " "▒▒▒" "   " "▒▒▒" "   " "▒▒▒" "▒▒▒" "▒▒▒" "▒▒▒" "▒▒▒" "   " "▒▒▒" "▒▒▒" "▒▒▒" "▒▒▒" "▒▒▒" "   " "   " "   " "▒▒▒" "   "
"   " "▒▒▒" "   " "   " "   " "   " "   " "   " "   " "   " "   " "   " "   " "   " "   " "   " "   " "▒▒▒" "   " "   " "   " 
