"   " "   " "   " "   " "   " "   " "   " "   " "▒▒▒" "▒▒▒" "▒▒▒" "▒▒▒" "▒▒▒" "▒▒▒" "▒▒▒" "▒▒▒" "▒▒▒" "▒▒▒" "▒▒▒" "▒▒▒" "▒▒▒" "▒▒▒" "▒▒▒" "▒▒▒" "▒▒▒" "▒▒▒" "▒▒▒" "▒▒▒" "▒▒▒" "▒▒▒" "▒▒▒" "▒▒▒" "▒▒▒" "▒▒▒" "▒▒▒" "▒▒▒" "▒▒▒" "▒▒▒" "▒▒▒" "▒▒▒" "▒▒▒" "▒▒▒" "▒▒▒" "▒▒▒" "▒▒▒" "▒▒▒" "▒▒▒" "▒▒▒" "▒▒▒" "▒▒▒" 
"▒▒▒" "▒▒▒" "▒▒▒" "▒▒▒" "▒▒▒" "▒▒▒" "▒▒▒" "   " "▒▒▒" "▒▒▒" "▒▒▒" "▒▒▒" "▒▒▒" "▒▒▒" "▒▒▒" "▒▒▒" "▒▒▒" "▒▒▒" "▒▒▒" "▒▒▒" "▒▒▒" "▒▒▒" "▒▒▒" "▒▒▒" "▒▒▒" "▒▒▒" "▒▒▒" "▒▒▒" "   " "   " "   " "   " "   " "   " "   " "▒▒▒" "▒▒▒" "▒▒▒" "▒▒▒" "▒▒▒" "▒▒▒" "▒▒▒" "▒▒▒" "▒▒▒" "▒▒▒" "▒▒▒" "▒▒▒" "▒▒▒" "▒▒▒" "▒▒▒" 
"▒▒▒" "▒▒▒" "▒▒▒" "▒▒▒" "▒▒▒" "▒▒▒" "▒▒▒" "   " "▒▒▒" "▒▒▒" "▒▒▒" "▒▒▒" "▒▒▒" "▒▒▒" "▒▒▒" "▒▒▒" "▒▒▒" "▒▒▒" "▒▒▒" "▒▒▒" "▒▒▒" "▒▒▒" "▒▒▒" "▒▒▒" "▒▒▒" "▒▒▒" "▒▒▒" "▒▒▒" "   " "▒▒▒" "▒▒▒" "▒▒▒" "▒▒▒" "▒▒▒" "   " "▒▒▒" "▒▒▒" "▒▒▒" "▒▒▒" "▒▒▒" "▒▒▒" "▒▒▒" "▒▒▒" "▒▒▒" "▒▒▒" "▒▒▒" "▒▒▒" "▒▒▒" "▒▒▒" "▒▒▒" 
"▒▒▒" "▒▒▒" "▒▒▒" "▒▒▒" "▒▒▒" "▒▒▒" "▒▒▒" "   " "▒▒▒" "▒▒▒" "▒▒▒" "▒▒▒" "▒▒▒" "▒▒▒" "▒▒▒" "▒▒▒" "   " "   " "   " "   " "   " "   " "   " "   " "   " "   " "   " "   " "   " "▒▒▒" "▒▒▒" "▒▒▒" "▒▒▒" "▒▒▒" "   " "▒▒▒" "▒▒▒" "▒▒▒" "▒▒▒" "▒▒▒" "▒▒▒" "▒▒▒" "▒▒▒" "▒▒▒" "▒▒▒" "▒▒▒" "▒▒▒" "▒▒▒" "▒▒▒" "▒▒▒" 
"▒▒▒" "▒▒▒" "▒▒▒" "▒▒▒" "▒▒▒" "▒▒▒" "▒▒▒" "   " "▒▒▒" "▒▒▒" "▒▒▒" "▒▒▒" "▒▒▒" "▒▒▒" "▒▒▒" "▒▒▒" "   " "▒▒▒" "▒▒▒" "▒▒▒" "▒▒▒" "▒▒▒" "▒▒▒" "▒▒▒" "▒▒▒" "▒▒▒" "▒▒▒" "▒▒▒" "▒▒▒" "▒▒▒" "▒▒▒" "▒▒▒" "▒▒▒" "▒▒▒" "   " "▒▒▒" "▒▒▒" "▒▒▒" "▒▒▒" "▒▒▒" "▒▒▒" "▒▒▒" "▒▒▒" "▒▒▒" "▒▒▒" "▒▒▒" "▒▒▒" "▒▒▒" "▒▒▒" "▒▒▒" 
"▒▒▒" "▒▒▒" "▒▒▒" "▒▒▒" "▒▒▒" "▒▒▒" "▒▒▒" "   " "▒▒▒" "▒▒▒" "▒▒▒" "▒▒▒" "▒▒▒" "▒▒▒" "▒▒▒" "▒▒▒" "   " "▒▒▒" "▒▒▒" "▒▒▒" "▒▒▒" "▒▒▒" "▒▒▒" "▒▒▒" "▒▒▒" "▒▒▒" "▒▒▒" "▒▒▒" "▒▒▒" "▒▒▒" "▒▒▒" "▒▒▒" "▒▒▒" "▒▒▒" "   " "▒▒▒" "▒▒▒" "▒▒▒" "▒▒▒" "▒▒▒" "▒▒▒" "▒▒▒" "▒▒▒" "▒▒▒" "▒▒▒" "▒▒▒" "▒▒▒" "▒▒▒" "▒▒▒" "▒▒▒" 
"▒▒▒" "▒▒▒" "▒▒▒" "▒▒▒" "▒▒▒" "▒▒▒" "▒▒▒" "   " "   " "   " "   " "   " "   " "   " "   " "   " "   " "▒▒▒" "▒▒▒" "▒▒▒" "▒▒▒" "▒▒▒" "▒▒▒" "▒▒▒" "   " "   " "   " "   " "   " "   " "   " "   " "   " "   " "   " "▒▒▒" "▒▒▒" "▒▒▒" "   " "   " "   " "   " "   " "   " "   " "   " "▒▒▒" "▒▒▒" "▒▒▒" "▒▒▒" 
"▒▒▒" "▒▒▒" "▒▒▒" "▒▒▒" "▒▒▒" "▒▒▒" "▒▒▒" "▒▒▒" "▒▒▒" "▒▒▒" "▒▒▒" "▒▒▒" "▒▒▒" "▒▒▒" "▒▒▒" "▒▒▒" "▒▒▒" "▒▒▒" "▒▒▒" "▒▒▒" "▒▒▒" "▒▒▒" "▒▒▒" "▒▒▒" "   " "▒▒▒" "▒▒▒" "▒▒▒" "▒▒▒" "▒▒▒" "▒▒▒" "▒▒▒" "▒▒▒" "▒▒▒" "▒▒▒" "▒▒▒" "▒▒▒" "▒▒▒" "   " "▒▒▒" "▒▒▒" "▒▒▒" "▒▒▒" "▒▒▒" "▒▒▒" "   " "▒▒▒" "▒▒▒" "▒▒▒" "▒▒▒" 
"▒▒▒" "▒▒▒" "▒▒▒" "▒▒▒" "▒▒▒" "▒▒▒" "▒▒▒" "▒▒▒" "▒▒▒" "▒▒▒" "▒▒▒" "▒▒▒" "▒▒▒" "▒▒▒" "▒▒▒" "▒▒▒" "▒▒▒" "▒▒▒" "▒▒▒" "▒▒▒" "▒▒▒" "▒▒▒" "▒▒▒" "▒▒▒" "   " "▒▒▒" "▒▒▒" "▒▒▒" "▒▒▒" "▒▒▒" "▒▒▒" "▒▒▒" "▒▒▒" "▒▒▒" "▒▒▒" "▒▒▒" "▒▒▒" "▒▒▒" "   " "▒▒▒" "▒▒▒" "▒▒▒" "▒▒▒" "▒▒▒" "▒▒▒" "   " "▒▒▒" "▒▒▒" "▒▒▒" "▒▒▒" 
"▒▒▒" "▒▒▒" "▒▒▒" "▒▒▒" "   " "   " "   " "   " "   " "   " "   " "   " "   " "   " "▒▒▒" "▒▒▒" "▒▒▒" "▒▒▒" "▒▒▒" "▒▒▒" "▒▒▒" "▒▒▒" "▒▒▒" "▒▒▒" "   " "▒▒▒" "▒▒▒" "▒▒▒" "▒▒▒" "▒▒▒" "▒▒▒" "▒▒▒" "▒▒▒" "▒▒▒" "▒▒▒" "▒▒▒" "▒▒▒" "▒▒▒" "   " "▒▒▒" "▒▒▒" "▒▒▒" "▒▒▒" "▒▒▒" "▒▒▒" "   " "▒▒▒" "▒▒▒" "▒▒▒" "▒▒▒" 
"   " "   " "▒▒▒" "▒▒▒" "   " "▒▒▒" "▒▒▒" "▒▒▒" "▒▒▒" "▒▒▒" "▒▒▒" "▒▒▒" "▒▒▒" "   " "▒▒▒" "▒▒▒" "▒▒▒" "▒▒▒" "▒▒▒" "▒▒▒" "▒▒▒" "▒▒▒" "▒▒▒" "▒▒▒" "   " "▒▒▒" "▒▒▒" "▒▒▒" "   " "   " "   " "   " "   " "   " "   " "   " "   " "   " "   " "▒▒▒" "▒▒▒" "▒▒▒" "▒▒▒" "▒▒▒" "▒▒▒" "   " "▒▒▒" "▒▒▒" "▒▒▒" "▒▒▒" 
"▒▒▒" "   " "▒▒▒" "▒▒▒" "   " "▒▒▒" "▒▒▒" "▒▒▒" "▒▒▒" "▒▒▒" "▒▒▒" "▒▒▒" "▒▒▒" "   " "▒▒▒" "▒▒▒" "▒▒▒" "▒▒▒" "▒▒▒" "▒▒▒" "▒▒▒" "▒▒▒" "▒▒▒" "▒▒▒" "   " "▒▒▒" "▒▒▒" "▒▒▒" "   " "▒▒▒" "▒▒▒" "▒▒▒" "▒▒▒" "▒▒▒" "▒▒▒" "▒▒▒" "▒▒▒" "▒▒▒" "▒▒▒" "▒▒▒" "▒▒▒" "   " "   " "   " "   " "♣ ⚷" "   " "   " "   " "▒▒▒"
"▒▒▒" "   " "▒▒▒" "▒▒▒" "   " "▒▒▒" "▒▒▒" "▒▒▒" "▒▒▒" "▒▒▒" "▒▒▒" "▒▒▒" "▒▒▒" "   " "▒▒▒" "▒▒▒" "▒▒▒" "▒▒▒" "▒▒▒" "▒▒▒" "▒▒▒" "▒▒▒" "▒▒▒" "▒▒▒" "   " "▒▒▒" "▒▒▒" "▒▒▒" "   " "▒▒▒" "▒▒▒" "▒▒▒" "▒▒▒" "▒▒▒" "▒▒▒" "▒▒▒" "▒▒▒" "▒▒▒" "▒▒▒" "▒▒▒" "▒▒▒" "   " "▒▒▒" "▒▒▒" "▒▒▒" "   " "▒▒▒" "▒▒▒" "   " "▒▒▒" 
"▒▒▒" "   " "▒▒▒" "▒▒▒" "   " "▒▒▒" "▒▒▒" "▒▒▒" "▒▒▒" "▒▒▒" "▒▒▒" "▒▒▒" "▒▒▒" "   " "   " "   " "   " "   " "   " "   " "   " "   " "   " "   " "   " "▒▒▒" "▒▒▒" "▒▒▒" "   " "▒▒▒" "▒▒▒" "▒▒▒" "▒▒▒" "▒▒▒" "▒▒▒" "▒▒▒" "▒▒▒" "▒▒▒" "▒▒▒" "▒▒▒" "▒▒▒" "   " "▒▒▒" "▒▒▒" "▒▒▒" "   " "▒▒▒" "▒▒▒" "   " "▒▒▒"
"▒▒▒" "♠ ⚷" "▒▒▒" "▒▒▒" "   " "▒▒▒" "▒▒▒" "▒▒▒" "▒▒▒" "▒▒▒" "▒▒▒" "▒▒▒" "▒▒▒" "▒▒▒" "▒▒▒" "▒▒▒" "▒▒▒" "▒▒▒" "▒▒▒" "▒▒▒" "▒▒▒" "▒▒▒" "▒▒▒" "▒▒▒" "▒▒▒" "▒▒▒" "▒▒▒" "▒▒▒" "   " "▒▒▒" "▒▒▒" "▒▒▒" "▒▒▒" "▒▒▒" "▒▒▒" "▒▒▒" "▒▒▒" "▒▒▒" "▒▒▒" "▒▒▒" "▒▒▒" "   " "▒▒▒" "▒▒▒" "▒▒▒" "   " "▒▒▒" "▒▒▒" "   " "▒▒▒"
"▒▒▒" "   " "▒▒▒" "▒▒▒" "   " "▒▒▒" "▒▒▒" "▒▒▒" "▒▒▒" "▒▒▒" "▒▒▒" "▒▒▒" "▒▒▒" "▒▒▒" "▒▒▒" "▒▒▒" "▒▒▒" "▒▒▒" "▒▒▒" "▒▒▒" "▒▒▒" "▒▒▒" "▒▒▒" "▒▒▒" "▒▒▒" "▒▒▒" "▒▒▒" "▒▒▒" "   " "▒▒▒" "▒▒▒" "▒▒▒" "▒▒▒" "▒▒▒" "▒▒▒" "▒▒▒" "▒▒▒" "▒▒▒" "▒▒▒" "▒▒▒" "▒▒▒" "   " "▒▒▒" "▒▒▒" "▒▒▒" "   " "   " "   " "   " "▒▒▒" 
"▒▒▒" "   " "▒▒▒" "▒▒▒" "   " "   " "   " "   " "   " "   " "   " "   " "   " "   " "   " "   " "   " "   " "   " "   " "   " "   " "▒▒▒" "▒▒▒" "▒▒▒" "▒▒▒" "▒▒▒" "▒▒▒" "   " "▒▒▒" "▒▒▒" "▒▒▒" "▒▒▒" "▒▒▒" "▒▒▒" "▒▒▒" "▒▒▒" "▒▒▒" "▒▒▒" "▒▒▒" "▒▒▒" "   " "▒▒▒" "▒▒▒" "▒▒▒" "▒▒▒" "▒▒▒" "▒▒▒" "▒▒▒" "▒▒▒" 
"▒▒▒" "   " "▒▒▒" "▒▒▒" "▒▒▒" "▒▒▒" "▒▒▒" "▒▒▒" "▒▒▒" "▒▒▒" "▒▒▒" "▒▒▒" "▒▒▒" "   " "▒▒▒" "▒▒▒" "▒▒▒" "▒▒▒" "▒▒▒" "▒▒▒" "▒▒▒" "   " "▒▒▒" "▒▒▒" "▒▒▒" "▒▒▒" "▒▒▒" "▒▒▒" "   " "▒▒▒" "▒▒▒" "▒▒▒" "▒▒▒" "▒▒▒" "▒▒▒" "▒▒▒" "▒▒▒" "▒▒▒" "▒▒▒" "▒▒▒" "▒▒▒" "   " "▒▒▒" "▒▒▒" "▒▒▒" "▒▒▒" "▒▒▒" "▒▒▒" "▒▒▒" "▒▒▒" 
"▒▒▒" "   " "▒▒▒" "▒▒▒" "▒▒▒" "▒▒▒" "▒▒▒" "▒▒▒" "▒▒▒" "▒▒▒" "▒▒▒" "▒▒▒" "▒▒▒" "   " "▒▒▒" "▒▒▒" "▒▒▒" "▒▒▒" "▒▒▒" "▒▒▒" "▒▒▒" "   " "▒▒▒" "▒▒▒" "▒▒▒" "▒▒▒" "▒▒▒" "▒▒▒" "   " "▒▒▒" "▒▒▒" "▒▒▒" "▒▒▒" "▒▒▒" "▒▒▒" "▒▒▒" "▒▒▒" "▒▒▒" "▒▒▒" "▒▒▒" "▒▒▒" "   " "▒▒▒" "▒▒▒" "▒▒▒" "▒▒▒" "▒▒▒" "▒▒▒" "▒▒▒" "▒▒▒" 
"▒▒▒" "   " "   " "   " "   " "▒▒▒" "▒▒▒" "▒▒▒" "▒▒▒" "▒▒▒" "▒▒▒" "▒▒▒" "▒▒▒" "   " "▒▒▒" "▒▒▒" "▒▒▒" "▒▒▒" "▒▒▒" "▒▒▒" "▒▒▒" "   " "   " "   " "   " "   " "   " "   " "   " "▒▒▒" "▒▒▒" "▒▒▒" "▒▒▒" "▒▒▒" "▒▒▒" "▒▒▒" "▒▒▒" "▒▒▒" "▒▒▒" "▒▒▒" "▒▒▒" "   " "▒▒▒" "▒▒▒" "▒▒▒" "▒▒▒" "▒▒▒" "▒▒▒" "▒▒▒" "▒▒▒" 
"▒▒▒" "▒▒▒" "▒▒▒" "▒▒▒" "   " "▒▒▒" "▒▒▒" "▒▒▒" "▒▒▒" "▒▒▒" "▒▒▒" "▒▒▒" "▒▒▒" "   " "▒▒▒" "▒▒▒" "▒▒▒" "▒▒▒" "▒▒▒" "▒▒▒" "▒▒▒" "▒▒▒" "▒▒▒" "▒▒▒" "▒▒▒" "▒▒▒" "▒▒▒" "▒▒▒" "▒▒▒" "▒▒▒" "▒▒▒" "▒▒▒" "▒▒▒" "▒▒▒" "▒▒▒" "▒▒▒" "▒▒▒" "▒▒▒" "▒▒▒" "▒▒▒" "▒▒▒" "   " "▒▒▒" "▒▒▒" "▒▒▒" "▒▒▒" "▒▒▒" "▒▒▒" "▒▒▒" "▒▒▒" 
"▒▒▒" "▒▒▒" "▒▒▒" "▒▒▒" "   " "▒▒▒" "▒▒▒" "▒▒▒" "▒▒▒" "▒▒▒" "▒▒▒" "▒▒▒" "▒▒▒" "   " "▒▒▒" "▒▒▒" "▒▒▒" "▒▒▒" "▒▒▒" "▒▒▒" "▒▒▒" "   " "   " "   " "   " "   " "   " "   " "   " "   " "   " "   " "   " "   " "   " "   " "   " "   " "   " "   " "   " "   " "▒▒▒" "▒▒▒" "▒▒▒" "▒▒▒" "▒▒▒" "▒▒▒" "▒▒▒" "▒▒▒" 
"▒▒▒" "▒▒▒" "▒▒▒" "▒▒▒" "   " "▒▒▒" "▒▒▒" "▒▒▒" "▒▒▒" "▒▒▒" "▒▒▒" "▒▒▒" "▒▒▒" "   " "▒▒▒" "▒▒▒" "▒▒▒" "▒▒▒" "▒▒▒" "▒▒▒" "▒▒▒" "   " "▒▒▒" "▒▒▒" "▒▒▒" "▒▒▒" "▒▒▒" "▒▒▒" "▒▒▒" "▒▒▒" "▒▒▒" "▒▒▒" "▒▒▒" "▒▒▒" "▒▒▒" "▒▒▒" "▒▒▒" "▒▒▒" "▒▒▒" "▒▒▒" "▒▒▒" "▒▒▒" "▒▒▒" "▒▒▒" "▒▒▒" "▒▒▒" "▒▒▒" "▒▒▒" "▒▒▒" "▒▒▒" 
"▒▒▒" "▒▒▒" "▒▒▒" "▒▒▒" "   " "▒▒▒" "▒▒▒" "▒▒▒" "▒▒▒" "▒▒▒" "▒▒▒" "▒▒▒" "▒▒▒" "   " "▒▒▒" "▒▒▒" "▒▒▒" "▒▒▒" "▒▒▒" "▒▒▒" "▒▒▒" "   " "▒▒▒" "▒▒▒" "▒▒▒" "   " "   " "   " "   " "   " "   " "   " "   " "   " "   " "   " "   " "   " "   " "   " "   " "   " "   " "   " "   " "   " "   " "   " "   " "▒▒▒" 
"▒▒▒" "▒▒▒" "▒▒▒" "▒▒▒" "   " "▒▒▒" "▒▒▒" "▒▒▒" "▒▒▒" "▒▒▒" "▒▒▒" "▒▒▒" "▒▒▒" "   " "   " "   " "   " "   " "   " "   " "   " "   " "▒▒▒" "▒▒▒" "▒▒▒" "   " "▒▒▒" "▒▒▒" "▒▒▒" "▒▒▒" "▒▒▒" "▒▒▒" "▒▒▒" "▒▒▒" "▒▒▒" "▒▒▒" "▒▒▒" "▒▒▒" "▒▒▒" "▒▒▒" "▒▒▒" "▒▒▒" "▒▒▒" "▒▒▒" "▒▒▒" "▒▒▒" "▒▒▒" "▒▒▒" "   " "▒▒▒" 
"▒▒▒" "▒▒▒" "▒▒▒" "▒▒▒" "   " "▒▒▒" "▒▒▒" "▒▒▒" "▒▒▒" "▒▒▒" "▒▒▒" "▒▒▒" "▒▒▒" "   " "▒▒▒" "▒▒▒" "▒▒▒" "▒▒▒" "▒▒▒" "▒▒▒" "▒▒▒" "▒▒▒" "▒▒▒" "▒▒▒" "▒▒▒" "   " "▒▒▒" "▒▒▒" "▒▒▒" "▒▒▒" "▒▒▒" "▒▒▒" "▒▒▒" "▒▒▒" "▒▒▒" "▒▒▒" "▒▒▒" "▒▒▒" "▒▒▒" "▒▒▒" "▒▒▒" "   " "   " "   " "   " "   " "   " "   " "   " "▒▒▒"
"▒▒▒" "▒▒▒" "▒▒▒" "▒▒▒" "   " "   " "   " "   " "▒▒▒" "▒▒▒" "▒▒▒" "▒▒▒" "▒▒▒" "♣ ꗃ" "▒▒▒" "▒▒▒" "▒▒▒" "▒▒▒" "▒▒▒" "▒▒▒" "▒▒▒" "▒▒▒" "▒▒▒" "▒▒▒" "▒▒▒" "   " "▒▒▒" "   " "   " "   " "   " "   " "   " "   " "   " "   " "   " "▒▒▒" "▒▒▒" "▒▒▒" "▒▒▒" "   " "▒▒▒" "▒▒▒" "▒▒▒" "▒▒▒" "   " "▒▒▒" "▒▒▒" "▒▒▒"
"▒▒▒" "▒▒▒" "▒▒▒" "▒▒▒" "▒▒▒" "▒▒▒" "▒▒▒" "   " "▒▒▒" "▒▒▒" "▒▒▒" "▒▒▒" "▒▒▒" "   " "   " "   " "   " "   " "   " "▒▒▒" "▒▒▒" "▒▒▒" "♥ ⚷" "   " "   " "   " "▒▒▒" "   " "▒▒▒" "▒▒▒" "▒▒▒" "▒▒▒" "▒▒▒" "▒▒▒" "▒▒▒" "▒▒▒" "   " "▒▒▒" "▒▒▒" "▒▒▒" "▒▒▒" "   " "▒▒▒" "▒▒▒" "▒▒▒" "▒▒▒" "   " "▒▒▒" "▒▒▒" "▒▒▒"
"▒▒▒" "▒▒▒" "▒▒▒" "▒▒▒" "▒▒▒" "▒▒▒" "▒▒▒" "   " "▒▒▒" "▒▒▒" "▒▒▒" "▒▒▒" "▒▒▒" "▒▒▒" "▒▒▒" "▒▒▒" "▒▒▒" "▒▒▒" "   " "▒▒▒" "▒▒▒" "▒▒▒" "▒▒▒" "▒▒▒" "▒▒▒" "▒▒▒" "▒▒▒" "   " "▒▒▒" "▒▒▒" "▒▒▒" "▒▒▒" "▒▒▒" "▒▒▒" "▒▒▒" "▒▒▒" "   " "▒▒▒" "▒▒▒" "▒▒▒" "▒▒▒" "   " "▒▒▒" "▒▒▒" "▒▒▒" "▒▒▒" "   " "▒▒▒" "▒▒▒" "▒▒▒" 
"▒▒▒" "   " "♠ ꗃ" "   " "▒▒▒" "▒▒▒" "▒▒▒" "   " "▒▒▒" "▒▒▒" "▒▒▒" "▒▒▒" "▒▒▒" "▒▒▒" "▒▒▒" "▒▒▒" "▒▒▒" "▒▒▒" "   " "▒▒▒" "▒▒▒" "▒▒▒" "▒▒▒" "▒▒▒" "▒▒▒" "▒▒▒" "▒▒▒" "   " "▒▒▒" "▒▒▒" "▒▒▒" "▒▒▒" "▒▒▒" "▒▒▒" "▒▒▒" "▒▒▒" "   " "▒▒▒" "▒▒▒" "▒▒▒" "▒▒▒" "   " "▒▒▒" "▒▒▒" "▒▒▒" "▒▒▒" "   " "▒▒▒" "▒▒▒" "▒▒▒"
"▒▒▒" "   " "▒▒▒" "   " "▒▒▒" "▒▒▒" "▒▒▒" "   " "▒▒▒" "▒▒▒" "▒▒▒" "▒▒▒" "▒▒▒" "▒▒▒" "▒▒▒" "▒▒▒" "▒▒▒" "▒▒▒" "   " "▒▒▒" "▒▒▒" "▒▒▒" "▒▒▒" "▒▒▒" "▒▒▒" "▒▒▒" "▒▒▒" "   " "▒▒▒" "▒▒▒" "▒▒▒" "▒▒▒" "▒▒▒" "▒▒▒" "▒▒▒" "▒▒▒" "   " "▒▒▒" "▒▒▒" "▒▒▒" "▒▒▒" "   " "▒▒▒" "▒▒▒" "▒▒▒" "▒▒▒" "   " "▒▒▒" "▒▒▒" "▒▒▒" 
"▒▒▒" "   " "▒▒▒" "   " "▒▒▒" "▒▒▒" "▒▒▒" "   " "   " "   " "   " "   " "   " "   " "   " "   " "   " "   " "   " "   " "   " "   " "   " "   " "   " "   " "   " "   " "▒▒▒" "▒▒▒" "▒▒▒" "▒▒▒" "▒▒▒" "▒▒▒" "▒▒▒" "▒▒▒" "   " "▒▒▒" "▒▒▒" "▒▒▒" "▒▒▒" "   " "▒▒▒" "▒▒▒" "▒▒▒" "▒▒▒" "   " "▒▒▒" "▒▒▒" "▒▒▒" 
"▒▒▒" "   " "▒▒▒" "   " "▒▒▒" "▒▒▒" "▒▒▒" "▒▒▒" "▒▒▒" "▒▒▒" "▒▒▒" "▒▒▒" "▒▒▒" "▒▒▒" "▒▒▒" "▒▒▒" "▒▒▒" "▒▒▒" "▒▒▒" "▒▒▒" "▒▒▒" "▒▒▒" "▒▒▒" "▒▒▒" "▒▒▒" "▒▒▒" "▒▒▒" "▒▒▒" "▒▒▒" "▒▒▒" "▒▒▒" "▒▒▒" "▒▒▒" "▒▒▒" "▒▒▒" "▒▒▒" "   " "   " "   " "   " "   " "   " "▒▒▒" "▒▒▒" "▒▒▒" "▒▒▒" "   " "▒▒▒" "▒▒▒" "▒▒▒" 
"▒▒▒" "   " "▒▒▒" "   " "▒▒▒" "▒▒▒" "▒▒▒" "▒▒▒" "▒▒▒" "▒▒▒" "▒▒▒" "▒▒▒" "▒▒▒" "▒▒▒" "▒▒▒" "▒▒▒" "▒▒▒" "▒▒▒" "▒▒▒" "▒▒▒" "▒▒▒" "▒▒▒" "▒▒▒" "▒▒▒" "▒▒▒" "▒▒▒" "▒▒▒" "▒▒▒" "▒▒▒" "▒▒▒" "▒▒▒" "▒▒▒" "▒▒▒" "▒▒▒" "▒▒▒" "▒▒▒" "▒▒▒" "▒▒▒" "▒▒▒" "▒▒▒" "▒▒▒" "▒▒▒" "▒▒▒" "▒▒▒" "▒▒▒" "▒▒▒" "   " "▒▒▒" "▒▒▒" "▒▒▒" 
"▒▒▒" "   " "▒▒▒" "   " "   " "   " "   " "   " "▒▒▒" "   " "   " "   " "   " "   " "   " "   " "   " "   " "   " "   " "   " "▒▒▒" "▒▒▒" "▒▒▒" "▒▒▒" "▒▒▒" "▒▒▒" "▒▒▒" "▒▒▒" "▒▒▒" "   " "   " "   " "   " "   " "   " "   " "   " "   " "   " "   " "   " "   " "   " "   " "   " "   " "▒▒▒" "▒▒▒" "▒▒▒" 
"▒▒▒" "   " "▒▒▒" "▒▒▒" "▒▒▒" "▒▒▒" "▒▒▒" "   " "▒▒▒" "   " "▒▒▒" "▒▒▒" "▒▒▒" "▒▒▒" "▒▒▒" "▒▒▒" "▒▒▒" "▒▒▒" "▒▒▒" "▒▒▒" "   " "▒▒▒" "▒▒▒" "▒▒▒" "▒▒▒" "▒▒▒" "▒▒▒" "▒▒▒" "▒▒▒" "▒▒▒" "   " "▒▒▒" "▒▒▒" "▒▒▒" "▒▒▒" "▒▒▒" "▒▒▒" "▒▒▒" "▒▒▒" "▒▒▒" "▒▒▒" "▒▒▒" "▒▒▒" "▒▒▒" "▒▒▒" "▒▒▒" "▒▒▒" "▒▒▒" "▒▒▒" "▒▒▒" 
"▒▒▒" "   " "▒▒▒" "▒▒▒" "▒▒▒" "▒▒▒" "▒▒▒" "   " "▒▒▒" "   " "▒▒▒" "♦ ⚷" "   " "   " "   " "   " "   " "   " "   " "▒▒▒" "   " "▒▒▒" "▒▒▒" "▒▒▒" "▒▒▒" "▒▒▒" "▒▒▒" "▒▒▒" "▒▒▒" "▒▒▒" "   " "▒▒▒" "▒▒▒" "▒▒▒" "▒▒▒" "▒▒▒" "▒▒▒" "▒▒▒" "▒▒▒" "▒▒▒" "▒▒▒" "▒▒▒" "▒▒▒" "▒▒▒" "▒▒▒" "▒▒▒" "▒▒▒" "▒▒▒" "▒▒▒" "▒▒▒"
"▒▒▒" "   " "▒▒▒" "▒▒▒" "▒▒▒" "▒▒▒" "▒▒▒" "   " "▒▒▒" "   " "▒▒▒" "▒▒▒" "▒▒▒" "▒▒▒" "▒▒▒" "▒▒▒" "▒▒▒" "▒▒▒" "   " "▒▒▒" "   " "▒▒▒" "▒▒▒" "▒▒▒" "▒▒▒" "▒▒▒" "▒▒▒" "▒▒▒" "▒▒▒" "▒▒▒" "   " "▒▒▒" "▒▒▒" "▒▒▒" "▒▒▒" "   " "   " "   " "   " "   " "   " "   " "   " "   " "   " "▒▒▒" "▒▒▒" "▒▒▒" "▒▒▒" "▒▒▒" 
"▒▒▒" "   " "▒▒▒" "▒▒▒" "▒▒▒" "▒▒▒" "▒▒▒" "   " "▒▒▒" "   " "▒▒▒" "▒▒▒" "   " "   " "   " "   " "   " "   " "   " "▒▒▒" "   " "   " "   " "   " "   " "   " "   " "   " "   " "   " "   " "▒▒▒" "▒▒▒" "▒▒▒" "▒▒▒" "   " "▒▒▒" "▒▒▒" "▒▒▒" "▒▒▒" "▒▒▒" "▒▒▒" "▒▒▒" "▒▒▒" "   " "▒▒▒" "▒▒▒" "▒▒▒" "▒▒▒" "▒▒▒" 
"▒▒▒" "   " "▒▒▒" "▒▒▒" "▒▒▒" "▒▒▒" "▒▒▒" "   " "▒▒▒" "   " "▒▒▒" "▒▒▒" "   " "▒▒▒" "▒▒▒" "▒▒▒" "▒▒▒" "▒▒▒" "   " "▒▒▒" "▒▒▒" "▒▒▒" "▒▒▒" "▒▒▒" "▒▒▒" "▒▒▒" "▒▒▒" "▒▒▒" "▒▒▒" "▒▒▒" "▒▒▒" "▒▒▒" "▒▒▒" "▒▒▒" "▒▒▒" "   " "▒▒▒" "▒▒▒" "▒▒▒" "▒▒▒" "▒▒▒" "▒▒▒" "▒▒▒" "▒▒▒" "   " "▒▒▒" "▒▒▒" "▒▒▒" "▒▒▒" "▒▒▒" 
"▒▒▒" "   " "▒▒▒" "   " "   " "   " "   " "   " "▒▒▒" "   " "▒▒▒" "▒▒▒" "   " "▒▒▒" "▒▒▒" "▒▒▒" "▒▒▒" "▒▒▒" "   " "▒▒▒" "▒▒▒" "▒▒▒" "▒▒▒" "▒▒▒" "▒▒▒" "▒▒▒" "▒▒▒" "▒▒▒" "▒▒▒" "▒▒▒" "▒▒▒" "▒▒▒" "▒▒▒" "▒▒▒" "▒▒▒" "   " "▒▒▒" "▒▒▒" "▒▒▒" "▒▒▒" "▒▒▒" "▒▒▒" "▒▒▒" "▒▒▒" "   " "▒▒▒" "▒▒▒" "▒▒▒" "▒▒▒" "▒▒▒" 
"▒▒▒" "   " "▒▒▒" "   " "▒▒▒" "▒▒▒" "▒▒▒" "▒▒▒" "▒▒▒" "   " "▒▒▒" "▒▒▒" "   " "▒▒▒" "▒▒▒" "▒▒▒" "▒▒▒" "▒▒▒" "   " "▒▒▒" "▒▒▒" "▒▒▒" "▒▒▒" "▒▒▒" "▒▒▒" "▒▒▒" "▒▒▒" "▒▒▒" "▒▒▒" "▒▒▒" "▒▒▒" "▒▒▒" "▒▒▒" "▒▒▒" "▒▒▒" "   " "▒▒▒" "   " "   " "   " "   " "   " "   " "   " "   " "▒▒▒" "▒▒▒" "▒▒▒" "▒▒▒" "▒▒▒" 
"▒▒▒" "   " "▒▒▒" "   " "▒▒▒" "▒▒▒" "▒▒▒" "▒▒▒" "▒▒▒" "   " "▒▒▒" "▒▒▒" "   " "▒▒▒" "▒▒▒" "▒▒▒" "▒▒▒" "▒▒▒" "   " "   " "   " "   " "   " "   " "   " "   " "   " "   " "   " "▒▒▒" "▒▒▒" "▒▒▒" "▒▒▒" "▒▒▒" "▒▒▒" "   " "▒▒▒" "   " "▒▒▒" "▒▒▒" "▒▒▒" "▒▒▒" "▒▒▒" "▒▒▒" "▒▒▒" "▒▒▒" "▒▒▒" "▒▒▒" "▒▒▒" "▒▒▒" 
"▒▒▒" "   " "▒▒▒" "   " "▒▒▒" "▒▒▒" "▒▒▒" "▒▒▒" "▒▒▒" "   " "▒▒▒" "▒▒▒" "   " "▒▒▒" "▒▒▒" "▒▒▒" "▒▒▒" "▒▒▒" "▒▒▒" "▒▒▒" "▒▒▒" "▒▒▒" "▒▒▒" "▒▒▒" "▒▒▒" "▒▒▒" "▒▒▒" "▒▒▒" "♦ ꗃ" "▒▒▒" "▒▒▒" "▒▒▒" "▒▒▒" "▒▒▒" "▒▒▒" "   " "▒▒▒" "   " "▒▒▒" "▒▒▒" "▒▒▒" "▒▒▒" "▒▒▒" "▒▒▒" "▒▒▒" "   " "♥ ꗃ" "   " "▒▒▒" "▒▒▒"
"▒▒▒" "   " "▒▒▒" "   " "   " "   " "   " "   " "   " "   " "▒▒▒" "▒▒▒" "   " "   " "   " "   " "   " "   " "   " "▒▒▒" "▒▒▒" "▒▒▒" "▒▒▒" "▒▒▒" "▒▒▒" "▒▒▒" "▒▒▒" "▒▒▒" "   " "▒▒▒" "▒▒▒" "▒▒▒" "▒▒▒" "▒▒▒" "▒▒▒" "   " "▒▒▒" "   " "   " "   " "   " "   " "   " "   " "   " "   " "▒▒▒" "   " "▒▒▒" "▒▒▒" 
"▒▒▒" "   " "▒▒▒" "▒▒▒" "▒▒▒" "▒▒▒" "▒▒▒" "▒▒▒" "▒▒▒" "▒▒▒" "▒▒▒" "▒▒▒" "▒▒▒" "▒▒▒" "▒▒▒" "▒▒▒" "▒▒▒" "▒▒▒" "   " "▒▒▒" "▒▒▒" "▒▒▒" "▒▒▒" "▒▒▒" "▒▒▒" "▒▒▒" "▒▒▒" "▒▒▒" "   " "▒▒▒" "▒▒▒" "▒▒▒" "▒▒▒" "▒▒▒" "▒▒▒" "   " "▒▒▒" "▒▒▒" "▒▒▒" "▒▒▒" "▒▒▒" "▒▒▒" "▒▒▒" "▒▒▒" "▒▒▒" "▒▒▒" "▒▒▒" "   " "▒▒▒" "▒▒▒" 
"▒▒▒" "   " "▒▒▒" "▒▒▒" "▒▒▒" "▒▒▒" "▒▒▒" "▒▒▒" "▒▒▒" "▒▒▒" "▒▒▒" "▒▒▒" "▒▒▒" "▒▒▒" "▒▒▒" "▒▒▒" "▒▒▒" "▒▒▒" "   " "▒▒▒" "▒▒▒" "▒▒▒" "   " "   " "   " "   " "   " "   " "   " "▒▒▒" "▒▒▒" "▒▒▒" "▒▒▒" "▒▒▒" "▒▒▒" "   " "▒▒▒" "▒▒▒" "▒▒▒" "   " "   " "   " "   " "   " "   " "   " "   " "   " "▒▒▒" "▒▒▒" 
"▒▒▒" "   " "   " "   " "   " "   " "   " "   " "   " "   " "   " "   " "   " "   " "   " "   " "   " "   " "   " "▒▒▒" "▒▒▒" "▒▒▒" "   " "▒▒▒" "▒▒▒" "▒▒▒" "▒▒▒" "▒▒▒" "▒▒▒" "▒▒▒" "▒▒▒" "▒▒▒" "▒▒▒" "▒▒▒" "▒▒▒" "   " "▒▒▒" "▒▒▒" "▒▒▒" "   " "▒▒▒" "▒▒▒" "▒▒▒" "▒▒▒" "▒▒▒" "▒▒▒" "▒▒▒" "▒▒▒" "▒▒▒" "▒▒▒" 
"▒▒▒" "▒▒▒" "▒▒▒" "▒▒▒" "▒▒▒" "▒▒▒" "▒▒▒" "▒▒▒" "▒▒▒" "▒▒▒" "▒▒▒" "▒▒▒" "▒▒▒" "▒▒▒" "▒▒▒" "▒▒▒" "▒▒▒" "▒▒▒" "▒▒▒" "▒▒▒" "▒▒▒" "▒▒▒" "   " "   " "   " "   " "   " "   " "   " "   " "   " "   " "   " "   " "   " "   " "▒▒▒" "▒▒▒" "▒▒▒" "   " "   " "   " "   " "   " "   " "   " "   " "   " "   " "▒▒▒" 
"▒▒▒" "▒▒▒" "▒▒▒" "▒▒▒" "▒▒▒" "▒▒▒" "▒▒▒" "▒▒▒" "▒▒▒" "▒▒▒" "▒▒▒" "▒▒▒" "▒▒▒" "▒▒▒" "▒▒▒" "▒▒▒" "▒▒▒" "▒▒▒" "▒▒▒" "▒▒▒" "▒▒▒" "▒▒▒" "▒▒▒" "▒▒▒" "▒▒▒" "▒▒▒" "▒▒▒" "▒▒▒" "▒▒▒" "▒▒▒" "▒▒▒" "▒▒▒" "▒▒▒" "▒▒▒" "▒▒▒" "▒▒▒" "▒▒▒" "▒▒▒" "▒▒▒" "▒▒▒" "▒▒▒" "▒▒▒" "▒▒▒" "▒▒▒" "▒▒▒" "▒▒▒" "▒▒▒" "▒▒▒" "   " "   " 
